##################
#                #
#      A@  @ oo  #
#                #
##################
